111111111111111111111111111111111
10C00000000000C1C0000000000000111
1000000001111111111111000000C0001
100000000000000000000000000000001
1C00111110000101110000C0000000111
100000C010000100010000C0010000001
100000001C000111010000C0010000001
111111101000010001000000010000001
10C000001000010111110000010000011
100C000010000100010000000C0000001
1P00000010000111E1000111111111111
1000000000000111110000000000000C1
111111111111111111111111111111111